AanI	TTATAA
AarI	CACCTGC
AasI	GAC......GTC
AatII	GACGTC
AbsI	CCTCGAGG
Acc16I	TGCGCA
Acc36I	ACCTGC
Acc65I	GGTACC
AccB1I	GG[CT][GA]CC
AccB7I	CCA.....TGG
AccBSI	CCGCTC
AccI	GT[AC][GT]AC
AccII	CGCG
AccIII	TCCGGA
AciI	CCGC
AclI	AACGTT
AclWI	GGATC
AcoI	[CT]GGCC[GA]
AcsI	[GA]AATT[CT]
AcuI	CTGAAG
AcvI	CACGTG
AcyI	G[GA]CG[CT]C
AdeI	CAC...GTG
AfaI	GTAC
AfeI	AGCGCT
AfiI	CC.......GG
AflII	CTTAAG
AflIII	AC[GA][CT]GT
AgeI	ACCGGT
AgsI	TT[GC]AA
AhdI	GAC.....GTC
AhlI	ACTAGT
AjiI	CACGTC
AjnI	CC[AT]GG
AjuI	GAA.......TTGG
AleI	CAC....GTG
AlfI	GCA......TGC
AloI	GAAC......TCC
AluBI	AGCT
AluI	AGCT
Alw21I	G[AT]GC[AT]C
Alw26I	GTCTC
Alw44I	GTGCAC
AlwI	GGATC
AlwNI	CAG...CTG
Ama87I	C[CT]CG[GA]G
Aor13HI	TCCGGA
Aor51HI	AGCGCT
ApaI	GGGCCC
ApaLI	GTGCAC
ApeKI	GC[AT]GC
ApoI	[GA]AATT[CT]
ArsI	GAC......TT[CT]G
AscI	GGCGCGCC
AseI	ATTAAT
AsiGI	ACCGGT
AsiSI	GCGATCGC
Asp700I	GAA....TTC
Asp718I	GGTACC
AspA2I	CCTAGG
AspLEI	GCGC
AspS9I	GG.CC
AsuC2I	CC[GC]GG
AsuHPI	GGTGA
AsuII	TTCGAA
AsuNHI	GCTAGC
AvaI	C[CT]CG[GA]G
AvaII	GG[AT]CC
AvrII	CCTAGG
AxyI	CCT.AGG
BaeGI	G[GT]GC[AC]C
BaeI	AC....GTA[CT]C
BalI	TGGCCA
BamHI	GGATCC
BanI	GG[CT][GA]CC
BanII	G[GA]GC[CT]C
BarI	GAAG......TAC
BauI	CACGAG
BbrPI	CACGTG
BbsI	GAAGAC
Bbv12I	G[AT]GC[AT]C
BbvCI	CCTCAGC
BbvI	GCAGC
BccI	CCATC
BceAI	ACGGC
BcgI	CGA......TGC
BciT130I	CC[AT]GG
BciVI	GTATCC
BclI	TGATCA
BcnI	CC[GC]GG
BcoDI	GTCTC
BcuI	ACTAGT
BfaI	CTAG
BfmI	CT[GA][CT]AG
BfoI	[GA]GCGC[CT]
BfrI	CTTAAG
BfuAI	ACCTGC
BfuCI	GATC
BfuI	GTATCC
BglI	GCC.....GGC
BglII	AGATCT
BlnI	CCTAGG
BlpI	GCT.AGC
BmcAI	AGTACT
Bme1390I	CC.GG
Bme18I	GG[AT]CC
BmeRI	GAC.....GTC
BmeT110I	C[CT]CG[GA]G
BmgBI	CACGTC
BmgT120I	GG.CC
BmiI	GG..CC
BmrFI	CC.GG
BmrI	ACTGGG
BmsI	GCATC
BmtI	GCTAGC
BmuI	ACTGGG
BoxI	GAC....GTC
BpiI	GAAGAC
BplI	GAG.....CTC
BpmI	CTGGAG
Bpu10I	CCT.AGC
Bpu1102I	GCT.AGC
Bpu14I	TTCGAA
BpuEI	CTTGAG
BpuMI	CC[GC]GG
Bsa29I	ATCGAT
BsaAI	[CT]ACGT[GA]
BsaBI	GAT....ATC
BsaHI	G[GA]CG[CT]C
BsaI	GGTCTC
BsaJI	CC..GG
BsaWI	[AT]CCGG[AT]
BsaXI	AC.....CTCC
Bsc4I	CC.......GG
Bse118I	[GA]CCGG[CT]
Bse1I	ACTGG
Bse21I	CCT.AGG
Bse3DI	GCAATG
Bse8I	GAT....ATC
BseAI	TCCGGA
BseBI	CC[AT]GG
BseCI	ATCGAT
BseDI	CC..GG
BseGI	GGATG
BseJI	GAT....ATC
BseLI	CC.......GG
BseMI	GCAATG
BseMII	CTCAG
BseNI	ACTGG
BsePI	GCGCGC
BseRI	GAGGAG
BseSI	G[GT]GC[AC]C
BseX3I	CGGCCG
BseXI	GCAGC
BseYI	CCCAGC
BsgI	GTGCAG
Bsh1236I	CGCG
Bsh1285I	CG[GA][CT]CG
BshFI	GGCC
BshNI	GG[CT][GA]CC
BshTI	ACCGGT
BshVI	ATCGAT
BsiEI	CG[GA][CT]CG
BsiHKAI	G[AT]GC[AT]C
BsiHKCI	C[CT]CG[GA]G
BsiSI	CCGG
BsiWI	CGTACG
BslFI	GGGAC
BslI	CC.......GG
BsmAI	GTCTC
BsmBI	CGTCTC
BsmFI	GGGAC
BsmI	GAATGC
BsnI	GGCC
Bso31I	GGTCTC
BsoBI	C[CT]CG[GA]G
Bsp119I	TTCGAA
Bsp120I	GGGCCC
Bsp1286I	G[AGT]GC[ACT]C
Bsp13I	TCCGGA
Bsp1407I	TGTACA
Bsp143I	GATC
Bsp1720I	GCT.AGC
Bsp19I	CCATGG
Bsp68I	TCGCGA
BspACI	CCGC
BspANI	GGCC
BspCNI	CTCAG
BspDI	ATCGAT
BspEI	TCCGGA
BspFNI	CGCG
BspHI	TCATGA
BspLI	GG..CC
BspMAI	CTGCAG
BspMI	ACCTGC
BspOI	GCTAGC
BspPI	GGATC
BspQI	GCTCTTC
BspT104I	TTCGAA
BspT107I	GG[CT][GA]CC
BspTI	CTTAAG
BspTNI	GGTCTC
BsrBI	CCGCTC
BsrDI	GCAATG
BsrFI	[GA]CCGG[CT]
BsrGI	TGTACA
BsrI	ACTGG
BsrSI	ACTGG
BssAI	[GA]CCGG[CT]
BssECI	CC..GG
BssHII	GCGCGC
BssKI	CC.GG
BssMI	GATC
BssNAI	GTATAC
BssNI	G[GA]CG[CT]C
BssSI	CACGAG
BssT1I	CC[AT][AT]GG
Bst1107I	GTATAC
Bst2BI	CACGAG
Bst2UI	CC[AT]GG
Bst4CI	AC.GT
Bst6I	CTCTTC
BstACI	G[GA]CG[CT]C
BstAFI	CTTAAG
BstAPI	GCA.....TGC
BstAUI	TGTACA
BstBAI	[CT]ACGT[GA]
BstBI	TTCGAA
BstC8I	GC..GC
BstDEI	CT.AG
BstDSI	CC[GA][CT]GG
BstEII	GGT.ACC
BstENI	CCT.....AGG
BstF5I	GGATG
BstFNI	CGCG
BstH2I	[GA]GCGC[CT]
BstHHI	GCGC
BstKTI	GATC
BstMAI	GTCTC
BstMBI	GATC
BstMCI	CG[GA][CT]CG
BstMWI	GC.......GC
BstNI	CC[AT]GG
BstNSI	[GA]CATG[CT]
BstOI	CC[AT]GG
BstPAI	GAC....GTC
BstPI	GGT.ACC
BstSCI	CC.GG
BstSFI	CT[GA][CT]AG
BstSLI	G[GT]GC[AC]C
BstSNI	TACGTA
BstUI	CGCG
BstV1I	GCAGC
BstV2I	GAAGAC
BstX2I	[GA]GATC[CT]
BstXI	CCA......TGG
BstYI	[GA]GATC[CT]
BstZ17I	GTATAC
BstZI	CGGCCG
Bsu15I	ATCGAT
Bsu36I	CCT.AGG
BsuI	GTATCC
BsuRI	GGCC
BsuTUI	ATCGAT
BtgI	CC[GA][CT]GG
BtrI	CACGTC
BtsCI	GGATG
BtsI	GCAGTG
BtsIMutI	CAGTG
BtuMI	TCGCGA
BveI	ACCTGC
Cac8I	GC..GC
CaiI	CAG...CTG
CciI	TCATGA
CciNI	GCGGCCGC
CfoI	GCGC
Cfr10I	[GA]CCGG[CT]
Cfr13I	GG.CC
Cfr42I	CCGCGG
Cfr9I	CCCGGG
ClaI	ATCGAT
CpoI	CGG[AT]CCG
CseI	GACGC
CsiI	ACC[AT]GGT
Csp6I	GTAC
CspAI	ACCGGT
CspCI	CAA.....GTGG
CspI	CGG[AT]CCG
CviAII	CATG
CviJI	[GA]GC[CT]
CviKI-1	[GA]GC[CT]
CviQI	GTAC
DdeI	CT.AG
DinI	GGCGCC
DpnII	GATC
DraI	TTTAAA
DraII	[GA]GG.CC[CT]
DraIII	CAC...GTG
DrdI	GAC......GTC
DriI	GAC.....GTC
DseDI	GAC......GTC
EaeI	[CT]GGCC[GA]
EagI	CGGCCG
Eam1104I	CTCTTC
Eam1105I	GAC.....GTC
EarI	CTCTTC
EciI	GGCGGA
Ecl136II	GAGCTC
EclXI	CGGCCG
Eco105I	TACGTA
Eco130I	CC[AT][AT]GG
Eco147I	AGGCCT
Eco24I	G[GA]GC[CT]C
Eco31I	GGTCTC
Eco32I	GATATC
Eco47I	GG[AT]CC
Eco47III	AGCGCT
Eco52I	CGGCCG
Eco53kI	GAGCTC
Eco57I	CTGAAG
Eco72I	CACGTG
Eco81I	CCT.AGG
Eco88I	C[CT]CG[GA]G
Eco91I	GGT.ACC
EcoICRI	GAGCTC
EcoNI	CCT.....AGG
EcoO109I	[GA]GG.CC[CT]
EcoO65I	GGT.ACC
EcoRI	GAATTC
EcoRII	CC[AT]GG
EcoRV	GATATC
EcoT14I	CC[AT][AT]GG
EcoT22I	ATGCAT
EcoT38I	G[GA]GC[CT]C
EgeI	GGCGCC
EheI	GGCGCC
ErhI	CC[AT][AT]GG
Esp3I	CGTCTC
FaeI	CATG
FaiI	[CT]AT[GA]
FalI	AAG.....CTT
FaqI	GGGAC
FatI	CATG
FauI	CCCGC
FauNDI	CATATG
FbaI	TGATCA
FblI	GT[AC][GT]AC
Fnu4HI	GC.GC
FokI	GGATG
FriOI	G[GA]GC[CT]C
FseI	GGCCGGCC
Fsp4HI	GC.GC
FspAI	[GA]TGCGCA[CT]
FspBI	CTAG
FspI	TGCGCA
GsaI	CCCAGC
GsuI	CTGGAG
HaeII	[GA]GCGC[CT]
HaeIII	GGCC
HapII	CCGG
HgaI	GACGC
HhaI	GCGC
Hin1I	G[GA]CG[CT]C
Hin1II	CATG
Hin6I	GCGC
HincII	GT[CT][GA]AC
HindII	GT[CT][GA]AC
HindIII	AAGCTT
HinfI	GA.TC
HinP1I	GCGC
HpaI	GTTAAC
HpaII	CCGG
HphI	GGTGA
Hpy166II	GT..AC
Hpy188I	TC.GA
Hpy188III	TC..GA
Hpy8I	GT..AC
Hpy99I	CG[AT]CG
HpyAV	CCTTC
HpyCH4III	AC.GT
HpyCH4IV	ACGT
HpyCH4V	TGCA
HpyF10VI	GC.......GC
HpyF3I	CT.AG
HpySE526I	ACGT
Hsp92I	G[GA]CG[CT]C
Hsp92II	CATG
HspAI	GCGC
KasI	GGCGCC
KflI	GGG[AT]CCC
Kpn2I	TCCGGA
KpnI	GGTACC
Ksp22I	TGATCA
KspAI	GTTAAC
KspI	CCGCGG
Kzo9I	GATC
LguI	GCTCTTC
LmnI	GCTCC
Lsp1109I	GCAGC
LweI	GCATC
M.AluI	AGCT
M.BamHI	GGATCC
M.BseCI	ATCGAT
M.ClaI	ATCGAT
M.EcoRI	GAATTC
M.Fsp4HI	GC.GC
M.HaeIII	GGCC
M.HapII	CCGG
M.HhaI	GCGC
M.HindIII	AAGCTT
M.HpaII	CCGG
M.HspAI	GCGC
M.MspI	CCGG
M.TaqI	TCGA
M3.BstF5I	GGATG
MabI	ACC[AT]GGT
MaeI	CTAG
MaeII	ACGT
MaeIII	GT.AC
MauBI	CGCGCGCG
MbiI	CCGCTC
MboI	GATC
MboII	GAAGA
MfeI	CAATTG
MflI	[GA]GATC[CT]
MhlI	G[AGT]GC[ACT]C
MlsI	TGGCCA
MluCI	AATT
MluI	ACGCGT
MluNI	TGGCCA
Mly113I	GGCGCC
MlyI	GAGTC
MmeI	TCC[GA]AC
MnlI	CCTC
Mox20I	TGGCCA
Mph1103I	ATGCAT
MreI	CGCCGGCG
MroI	TCCGGA
MroNI	GCCGGC
MroXI	GAA....TTC
MscI	TGGCCA
MseI	TTAA
MslI	CA[CT]....[GA]TG
Msp20I	TGGCCA
MspA1I	C[AC]GC[GT]G
MspCI	CTTAAG
MspI	CCGG
MspR9I	CC.GG
MssI	GTTTAAAC
MunI	CAATTG
Mva1269I	GAATGC
MvaI	CC[AT]GG
MvnI	CGCG
MwoI	GC.......GC
NaeI	GCCGGC
NarI	GGCGCC
Nb.BbvCI	CCTCAGC
Nb.Bpu10I	CCT.AGC
Nb.BsmI	GAATGC
Nb.BsrDI	GCAATG
Nb.BtsI	GCAGTG
Nb.Mva1269I	GAATGC
NciI	CC[GC]GG
NcoI	CCATGG
NdeI	CATATG
NdeII	GATC
NgoMIV	GCCGGC
NheI	GCTAGC
NlaIII	CATG
NlaIV	GG..CC
NmeAIII	GCCGAG
NmuCI	GT[GC]AC
NotI	GCGGCCGC
NruI	TCGCGA
NsbI	TGCGCA
NsiI	ATGCAT
NspI	[GA]CATG[CT]
NspV	TTCGAA
Nt.AlwI	GGATC
Nt.BbvCI	CCTCAGC
Nt.Bpu10I	CCT.AGC
Nt.BsmAI	GTCTC
Nt.BspQI	GCTCTTC
Nt.Bst9I	GAGTC
Nt.BstNBI	GAGTC
Nt.CviPII	CC[AGT]
OliI	CAC....GTG
PacI	TTAATTAA
PaeI	GCATGC
PaeR7I	CTCGAG
PagI	TCATGA
PalAI	GGCGCGCC
PasI	CCC[AT]GGG
PauI	GCGCGC
PceI	AGGCCT
PciI	ACATGT
PciSI	GCTCTTC
PctI	GAATGC
PdiI	GCCGGC
PdmI	GAA....TTC
PfeI	GA[AT]TC
Pfl23II	CGTACG
PflFI	GAC...GTC
PflMI	CCA.....TGG
PfoI	TCC.GGA
PinAI	ACCGGT
Ple19I	CGATCG
PleI	GAGTC
PluTI	GGCGCC
PmaCI	CACGTG
PmeI	GTTTAAAC
PmlI	CACGTG
PpsI	GAGTC
Ppu21I	[CT]ACGT[GA]
PpuMI	[GA]GG[AT]CC[CT]
PscI	ACATGT
PshAI	GAC....GTC
PshBI	ATTAAT
PsiI	TTATAA
Psp124BI	GAGCTC
Psp1406I	AACGTT
Psp5II	[GA]GG[AT]CC[CT]
Psp6I	CC[AT]GG
PspCI	CACGTG
PspEI	GGT.ACC
PspFI	CCCAGC
PspGI	CC[AT]GG
PspLI	CGTACG
PspN4I	GG..CC
PspOMI	GGGCCC
PspPI	GG.CC
PspPPI	[GA]GG[AT]CC[CT]
PspXI	[ACG]CTCGAG[CGT]
PsrI	GAAC......TAC
PstI	CTGCAG
PstNI	CAG...CTG
PsuI	[GA]GATC[CT]
PsyI	GAC...GTC
PteI	GCGCGC
PvuI	CGATCG
PvuII	CAGCTG
RgaI	GCGATCGC
RigI	GGCCGGCC
RruI	TCGCGA
RsaI	GTAC
RsaNI	GTAC
RseI	CA[CT]....[GA]TG
Rsr2I	CGG[AT]CCG
RsrII	CGG[AT]CCG
SacI	GAGCTC
SacII	CCGCGG
SalI	GTCGAC
SapI	GCTCTTC
SaqAI	TTAA
SatI	GC.GC
Sau3AI	GATC
Sau96I	GG.CC
SbfI	CCTGCAGG
ScaI	AGTACT
SchI	GAGTC
ScrFI	CC.GG
SdaI	CCTGCAGG
SduI	G[AGT]GC[ACT]C
SetI	A[GC][GC]T
SexAI	ACC[AT]GGT
SfaAI	GCGATCGC
SfaNI	GCATC
SfcI	CT[GA][CT]AG
SfiI	GGCC.....GGCC
SfoI	GGCGCC
Sfr274I	CTCGAG
Sfr303I	CCGCGG
SfuI	TTCGAA
SgfI	GCGATCGC
SgrAI	C[GA]CCGG[CT]G
SgrBI	CCGCGG
SgrDI	CGTCGACG
SgsI	GGCGCGCC
SinI	GG[AT]CC
SlaI	CTCGAG
SmaI	CCCGGG
SmiI	ATTTAAAT
SmiMI	CA[CT]....[GA]TG
SmlI	CT[CT][GA]AG
SmoI	CT[CT][GA]AG
SnaBI	TACGTA
SpeI	ACTAGT
SphI	GCATGC
SrfI	GCCCGGGC
Sse8387I	CCTGCAGG
Sse9I	AATT
SseBI	AGGCCT
SsiI	CCGC
SspDI	GGCGCC
SspI	AATATT
SspMI	CTAG
SstI	GAGCTC
StuI	AGGCCT
StyD4I	CC.GG
StyI	CC[AT][AT]GG
SwaI	ATTTAAAT
TaaI	AC.GT
TaiI	ACGT
TaqI	TCGA
TaqII	GACCGA
TasI	AATT
TatI	[AT]GTAC[AT]
TauI	GC[GC]GC
TfiI	GA[AT]TC
Tru1I	TTAA
Tru9I	TTAA
TscAI	CA[GC]TG
TseFI	GT[GC]AC
TseI	GC[AT]GC
Tsp45I	GT[GC]AC
TspDTI	ATGAA
TspGWI	ACGGA
TspMI	CCCGGG
TspRI	CA[GC]TG
Tth111I	GAC...GTC
Van91I	CCA.....TGG
Vha464I	CTTAAG
VneI	GTGCAC
VpaK11BI	GG[AT]CC
VspI	ATTAAT
XagI	CCT.....AGG
XapI	[GA]AATT[CT]
XbaI	TCTAGA
XceI	[GA]CATG[CT]
XcmI	CCA.........TGG
XhoI	CTCGAG
XhoII	[GA]GATC[CT]
XmaI	CCCGGG
XmaJI	CCTAGG
XmiI	GT[AC][GT]AC
XmnI	GAA....TTC
XspI	CTAG
ZraI	GACGTC
ZrmI	AGTACT
Zsp2I	ATGCAT